$$$$$$$$$$$$$$$$$$$$
$..................$
$.@................$
$..................$
$..................$
$..................$
$..................$
$..................$
$$$$$$$$$$$$$$$$$$$$