$$$$$$$$$$$$$$$$$$$$$$$$$$$$$$$$$$$$$$$$$$$$$$$$$$$$$$$$$$$$$$$$$$$$$$$$$$$$$$$$$$$$$$$$$$$$$$$$$$$$
$@....#...........#.#...#.....#.#.....#.........#.#.....#######...#.........#.....#...#...........#$
$.###.#.#####.###.#.#.#.#####.#.#.###.#.#######.#.#.###.#######.#.#.#####.###.###.#.#.#.#########.#$
$.#...#.....#.#.#.....#.......#.....#.#.....#.#.#.#.#.#.......#.#.......#.......#...#...#...#...#.#$
$.#######.###.#.#############.#######.#####.#.#.#.#.#.#######.#.###############.###########.#.#.#.#$
$.......#.#...#.#...#.......#...............#.#.#.....#.#.....#.#...........#.#.#...........#.#.#.#$
$######.#.#.###.#.###.#.###.#################.#.#####.#.#.#####.#.#########.#.#.#####.#####.###.#.#$
$.......#.#.#...#...#.#...#.....#...........#.#...#.#...#.......#.#...#.....#.........#...#.#...#.#$
$.#########.#.#.###.#.#####.###.#.#####.#####.###.#.#.#####.#####.#.###.###############.#.#.#.###.#$
$.#.....#...#.#...#...#.....#...#.#...#...#.......#...#...#.#...#.#.....#.....#...#.....#.....#...#$
$.#####.#.#####.#.#######.###.#.#.###.###.#.###########.#.#.#.###.#.#####.###.###.#.#########.#.###$
$.#...#...#...#.#.....#...#...#.#.......#...#...#.......#.#...#...#.......#...#...#.....#...#.#...#$
$.#.#.###.#.#.#.#####.#.###############.#####.#.#.#######.#####.###########.###.#######.#.#.#####.#$
$...#...#.#.#.#...#...#.#...#.........#.....#.#...#...#.#.......#.#.........#.#.........#.#.....#.#$
$######.#.#.#.###.#.###.#.#.#.#######.#####.#.#####.#.#.#########.#.#########.#.#####.###.#####.#.#$
$.....#...#.#.....#.#...#.#...#...#...#.....#.......#.#...........#.#.....#.#...#...#...#.#...#...#$
$.#########.#######.#.###.#####.#.#.###.#####.#####.#.#.#########.#.###.#.#.#.###.#.#####.###.#.###$
$.........#.....#.....#...#...#.#.#.#...#...#.#...#.#.#...#.......#.....#.#.....#.#.....#...#.#...#$
$##.#######.###.#######.#####.#.#.#.#.###.###.#.#.###.###.#.#############.#.#####.#####.###.#.###.#$
$...#...#...#.#.......#.......#.#...#.#...#...#.#.....#...#...#.......#...#...#.......#.....#.#.#.#$
$.#.#.#.#.###.#######.#####.###.#####.#.###.###.#######.#####.#.#.#####.#######.#############.#.#.#$
$.#...#...#...#...........#.#...#.....#.#.....#.#.....#.#...#...#.#.....#.....#.............#.....#$
$.#########.###.#.#########.#.#.#.#####.#.#####.#.#.###.#.#######.#.#####.#.#.#############.#.#####$
$...#.......#...#.#.........#.#.#.#...#...#...#.#.#.#...#...#.....#...#...#.#...#.....#.....#.#...#$
$##.#.#####.#.###.#.###########.#.#.#.###.#.#.#.###.#.#.###.#.#.#####.###.#.###.###.#.#.#.#####.#.#$
$...#...#...#...#.#...#.......#.#...#...#...#.#.#...#.#.....#.#.#...#...#.#...#...#.#...#.......#.#$
$.#####.#.#####.#####.#.#####.#.#######.#####.#.#.###.#####.#.#.#.#.###.###.#.###.#####.#########.#$
$.#.....#...#.#...#...#.....#.#.#...#...#.....#.#.....#...#.#.#...#...#.#...#.#.#.....#.#...#.#...#$
$.#.#######.#.###.#.###.###.#.#.#.#.#.#########.#######.#.###.#########.#.###.#.#####.###.#.#.#.#.#$
$.#.#...#...#...#.#.#.....#.#.#...#.#.#.........#...#...#.....#.....#...#...#.#...#.#.#...#.#.#.#.#$
$.#.#.###.###.#.#.#.#######.#.#####.#.#.#########.#.#.#.#######.###.#.#####.#.#.#.#.#.#.###.#.#.#.#$
$...#...#.....#.#...#.......#.....#.#...#.........#...#.....#...#.#.#.#.....#.#.#.#.#...#.#.#...#.#$
$######.#######.#####.#########.###.###########.###########.#.###.#.#.#####.#.###.#.#####.#.#####.#$
$.......#...#...#.....#.....#...#...#.#.......#.#...#.......#...#.#.#.....#.#...#.#.......#.#...#.#$
$.#######.#.#.###.#####.###.#.###.###.#.#.###.###.#.#.###.#####.#.#.#####.#.###.#.#.#####.#.#.#.#.#$
$.#.......#.#.#...#...#...#.#...#.......#...#.....#.#.#.....#.....#.......#...#.#...#.....#...#...#$
$.#.#######.#.#.###.#.#.#.#.###.###########.#######.#.#####.#.###############.#.#####.#.#########.#$
$.....#.#...#.#.#...#...#.#.#.......#.#.....#.........#...#.#.#.........#.....#...#...#.#...#...#.#$
$.###.#.#.#.#.#.###.#####.#.#.#####.#.#.#####.#########.#.#.#.#.#######.#########.#.###.#.#.#.#.#.#$
$.#.....#.#.#.#...#.#...#.#...#...#...#.#.....#.#.......#.#.#.#.....#...#.........#.#.....#.#.#...#$
$.#####.#.###.###.#.#.#.#######.#.###.#.###.###.#.#######.#.#.#######.#.#.#########.#.#######.#####$
$.#...#.#.......#.#.#.#.....#...#...#.#.#...#...#...#...#.#.#.#.......#...#.........#.#...#.......#$
$##.#.#########.#.###.#####.#.#####.###.#.###.#####.###.#.#.#.#.###########.###.###.#.###.#.#####.#$
$...#...#.........#...#...#.#.#...#.....#.....#.....#...#.#.#.#...#.#...#...#...#.#.#.....#...#.#.#$
$.#####.###.#######.###.###.#.#.#.###.#####.###.#####.###.###.###.#.#.#.#.###.###.#.###.#####.#.#.#$
$.....#...#...#...#.#.#.....#.#.#.....#...#.#...#.#.....#.....#...#.#.#.....#.#.....#...#...#.#...#$
$.###.###.###.###.#.#.#.#.###.#########.#.###.###.#.###.#######.###.#.#######.#.#########.#.#.#####$
$...#.#.#...#.....#.#...#.#...........#.#...#...#...#...#.........#...#.....#.#.#.....#...#.#...###$
$##.#.#.###.###.###.#####.#.#########.#.###.###.#####.#.#########.#.###.###.#.###.###.#.###.###.###$
$...#.#.#...#.#.#.#.....#.#...#.......#.#.#...#.#.....#.....#.....#.#...#.#.#...#...#.#...#...#...#$
$####.#.#.###.#.#.#####.#.###.#.###.###.#.#.###.###.#######.#.#######.###.#.###.###.#.#.###.#.###.#$
$.....#.#.#.....#.....#.#...#.#.#...#...#.#...#.....#...#.#.#...#.....#...#.....#...#...#...#...#.#$
$.#####.#.#.#########.#.###.###.#.###.###.###.#########.#.#.###.###.###.#######.#.#######.#####.#.#$
$.#.......#.........#.#.#.......#...#.......#...#.......#...#...#.....#.........#...#.#...#.....#.#$
$.#####.###########.#.#.#.#####.###########.#.###.#.#####.###.###.#####.###########.#.#.###.#####.#$
$.....#.........#.....#.#.#...#.#...........#...#.#...#...#...#.......#.#...#.......#.#.#...#.#...#$
$##.###########.#######.###.#.###.#########.###.#.#.#.#.###.#.#.#####.###.#.#.#######.#.#.###.#.###$
$...#...#.....#.....#...#...#.....#.....#.....#...#.#...#...#.#.#...#.#...#...#.....#.#.#.....#...#$
$.###.###.###.#####.#.#.#.#########.###.#################.###.###.#.#.#.#########.#.#.#.#########.#$
$.#.......#.#.....#.#.#.#.........#.#.......#.........#.#...#.#...#.#.#.#.........#.#.#.....#.#...#$
$.#####.###.#####.#.#.###########.#.#######.#.#######.#.###.#.#.###.#.#.#.#########.#.#.###.#.#.###$
$...#...#.....#...#.#.......#...#...#.......#.#...#...#.#...#.#...#.#.#...#.....#...#.#.#.....#...#$
$.#.###.#.###.#.###.#.#.###.#.#.#####.#######.#.###.###.#.###.###.#.#.#####.###.#.###.#.#########.#$
$.#.#.....#...#.....#.#.#...#.#.#...#.........#.......#.#...#.....#.#.........#.#.....#.#.........#$
$##.#.#########.#######.#.###.#.#.#.#################.#.#.#########.#########.#.###.###.#.#########$
$...#.#.......#.......#.#.#...#...#.......#.....#.....#...#.......#.......#...#.#.#.#...#.#.#.....#$
$.#####.#####.#######.#.#.#.#.#####.#####.#.###.#.#####.###.#.#####.#####.#####.#.#.#.###.#.#.###.#$
$...#...#...#.......#...#.#.#.#.....#...#.#.#...#.....#.#...#.#...#.#.....#.....#...#.#...#.#.#...#$
$##.#.###.#.#######.#####.#.#.#######.#.###.#.#######.#.#.###.#.#.#.#.#####.#.#####.#.#.###.#.#.###$
$...#...#.#.......#.#...#.#.#.#.......#.....#.........#.#...#...#.#.#...#...#.......#.#.#.....#...#$
$.#####.#######.###.#.###.###.#.#######################.###.#####.#.###.#########.###.#.#.#######.#$
$.#.....#.......#...#...#...#.#...#.............#.#...#...#.#.....#.#...#...#...#.#...#.#.#.#...#.#$
$.#.#####.###.###.#####.###.#.###.#.###########.#.#.#.###.###.#.#####.###.#.#.#.###.###.#.#.#.#.#.#$
$.#...#...#...#...#...#...#.#.#...#.#.....#...#.....#...#.....#.#...#.#...#...#...#...#.#.....#.#.#$
$.###.#.###.###.###.#.#.#.#.#.#.###.#.###.#.#.#######.#######.###.#.#.#.#########.#.#.#.#######.#.#$
$.#...#...#...#...#.#...#.....#.#.#...#.#...#.#...#...#.......#...#.#.......#.....#.#.#...#.....#.#$
$.#.###.#.###.###.#############.#.#####.#####.###.#.###.#.#####.###.#########.#####.#.###.#.#####.#$
$...#...#...#...#.........#.....#.........#.....#.#.....#...#...#.#.#.........#.....#...#.#.#...#.#$
$.#####.###.###.#########.#.#########.###.#####.#.#####.#####.###.#.#.###.#####.#######.#.###.#.#.#$
$.....#...#.#...#.....#.#.#.#.......#...#.....#.#.#...#.#...#.#.....#...#.#.....#.....#.#.....#...#$
$####.###.#.###.#.#.#.#.#.#.#.#####.#####.#.###.#.#.#.#.#.#.#.#####.#####.#.#####.###.#.#########.#$
$...#.#...#...#.#.#.#...#.#...#...#.....#.#...#...#.#.#.#.#...#...#.......#.#.....#.#.#...#.....#.#$
$##.#.#######.###.#.###.#.#####.#.#####.#.###.#.###.#.###.#####.#.#########.#.#####.#.#.#.###.#.#.#$
$...#.......#.....#.#...#.....#.#.#...#.#...#...#...#.....#.....#.#.#.....#...#.......#.#.....#.#.#$
$.#########.#.#######.#.#####.#.#.#.#.#.#########.###########.###.#.#.#.#.#####.#####.#.#######.#.#$
$...........#...#...#.#.....#...#.#.#.#.........#.#...........#.#...#.#.#...#...#...#.#.#.....#.#.#$
$.###############.#.#######.#####.###.#########.#.#######.#.###.###.#.#.###.#.###.#.###.#.###.###.#$
$.....#...#.....#.#.......#...#...#...........#.#.......#.#...#.....#.#.#...#...#.#...#.#.#.#.#...#$
$####.#.#.#.###.#.#######.#.###.###.#########.#.#######.#####.#######.#.#.#####.#.###.#.#.#.#.#.###$
$...#...#...#.#...#.#...#...#...#...#...#.#...#.....#...#...#.........#.#.#.....#...#.#.#.#.#.#...#$
$.#.#########.#####.#.#.###.#.###.#.###.#.#.#######.#.###.#.#.###########.#.#######.#.#.#.#.#.###.#$
$.#...#...............#...#.#.....#.#.....#...#.....#.....#.#...#.....#...#.#.#.....#...#.#.#...#.#$
$.#####.###############.###.#######.#.#####.###.#####.#####.###.###.#.#.###.#.#.#######.#.#.#.#.#.#$
$.....#.......#...#...#.....#.....#.#.....#.#.......#.#...#.#.#.....#.#...#...#...#...#.#...#.#.#.#$
$####.#######.#.#.#.#.#######.###.#.###.#.#.#.#####.#.#.#.#.#.#######.###.###.###.#.###.###.#.###.#$
$.#...#.......#.#...#.....#...#...#...#.#...#...#...#...#.#.#.......#...#...#.#.#.#.......#.#.....#$
$.#.#.#.#######.#########.#.#.#.#####.#########.#.#########.###.###.###.###.#.#.#.#########.#.#####$
$...#...........#...........#.#.....#...........#...........#.....#.......#.....#...........#.....#$
$##################################################################################################$
$$$$$$$$$$$$$$$$$$$$$$$$$$$$$$$$$$$$$$$$$$$$$$$$$$$$$$$$$$$$$$$$$$$$$$$$$$$$$$$$$$$$$$$$$$$$$$$$$$$$
